{
    "rooms": [["s", "s", "s", "s", "s", "s", "s", "s", "s", "s", "s", "s", "s"],
              ["s",  0,   0,   0,   0,   0,  "s",  1,   1,   1,   1,   1,  "s"],
              ["s",  0,   0,   0,   0,   0,  "p",  1,   1,   1,   1,   1,  "s"],
              ["s",  0,   0,   0,   0,   0,  "s",  1,   1,   1,   1,   1,  "s"],
              ["s",  0,   0,   0,   0,   0,  "p",  1,   1,   1,   1,   1,  "s"],
              ["s",  0,   0,   0,   0,   0,  "s",  1,   1,   1,   1,   1,  "s"],
              ["s", "s", "s", "p", "s", "s", "s", "s", "s", "p", "s", "s", "s"],
              ["s",  2,   2,   2,   2,   2,  "s",  3,   3,   3,   3,   3,  "s"],
              ["s",  2,   2,   2,   2,   2,  "p",  3,   3,   3,   3,   3,  "s"],
              ["s",  2,   2,   2,   2,   2,  "s",  3,   3,   3,   3,   3,  "s"],
              ["s",  2,   2,   2,   2,   2,  "p",  3,   3,   3,   3,   3,  "s"],
              ["s",  2,   2,   2,   2,   2,  "s",  3,   3,   3,   3,   3,  "s"],
              ["s", "s", "s", "p", "s", "s", "s", "s", "s", "p", "s", "s", "s"],
              ["s",  4,   4,   4,   4,   4,  "s",  5,   5,   5,   5,   5,  "s"],
              ["s",  4,   4,   4,   4,   4,  "p",  5,   5,   5,   5,   5,  "s"],
              ["s",  4,   4,   4,   4,   4,  "s",  5,   5,   5,   5,   5,  "s"],
              ["s",  4,   4,   4,   4,   4,  "p",  5,   5,   5,   5,   5,  "s"],
              ["s",  4,   4,   4,   4,   4,  "s",  5,   5,   5,   5,   5,  "s"],
              ["s", "s", "s", "s", "s", "s", "s", "s", "s", "s", "s", "s", "s"],
             ["s", "s", "s", "s", "s", "s", "s", "s", "s", "s", "s", "s", "s"],
              ["s",  0,   0,   0,   0,   0,  "s",  1,   1,   1,   1,   1,  "s"],
              ["s",  0,   0,   0,   0,   0,  "p",  1,   1,   1,   1,   1,  "s"],
              ["s",  0,   0,   0,   0,   0,  "s",  1,   1,   1,   1,   1,  "s"],
              ["s",  0,   0,   0,   0,   0,  "p",  1,   1,   1,   1,   1,  "s"],
              ["s",  0,   0,   0,   0,   0,  "s",  1,   1,   1,   1,   1,  "s"],
              ["s", "s", "s", "p", "s", "s", "s", "s", "s", "p", "s", "s", "s"],
              ["s",  2,   2,   2,   2,   2,  "s",  3,   3,   3,   3,   3,  "s"],
              ["s",  2,   2,   2,   2,   2,  "p",  3,   3,   3,   3,   3,  "s"],
              ["s",  2,   2,   2,   2,   2,  "s",  3,   3,   3,   3,   3,  "s"],
              ["s",  2,   2,   2,   2,   2,  "p",  3,   3,   3,   3,   3,  "s"],
              ["s",  2,   2,   2,   2,   2,  "s",  3,   3,   3,   3,   3,  "s"],
              ["s", "s", "s", "p", "s", "s", "s", "s", "s", "p", "s", "s", "s"],
              ["s",  4,   4,   4,   4,   4,  "s",  5,   5,   5,   5,   5,  "s"],
              ["s",  4,   4,   4,   4,   4,  "p",  5,   5,   5,   5,   5,  "s"],
              ["s",  4,   4,   4,   4,   4,  "s",  5,   5,   5,   5,   5,  "s"],
              ["s",  4,   4,   4,   4,   4,  "p",  5,   5,   5,   5,   5,  "s"],
              ["s",  4,   4,   4,   4,   4,  "s",  5,   5,   5,   5,   5,  "s"],
              ["s", "s", "s", "s", "s", "s", "s", "s", "s", "s", "s", "s", "s"],
             ["s", "s", "s", "s", "s", "s", "s", "s", "s", "s", "s", "s", "s"],
              ["s",  0,   0,   0,   0,   0,  "s",  1,   1,   1,   1,   1,  "s"],
              ["s",  0,   0,   0,   0,   0,  "p",  1,   1,   1,   1,   1,  "s"],
              ["s",  0,   0,   0,   0,   0,  "s",  1,   1,   1,   1,   1,  "s"],
              ["s",  0,   0,   0,   0,   0,  "p",  1,   1,   1,   1,   1,  "s"],
              ["s",  0,   0,   0,   0,   0,  "s",  1,   1,   1,   1,   1,  "s"],
              ["s", "s", "s", "p", "s", "s", "s", "s", "s", "p", "s", "s", "s"],
              ["s",  2,   2,   2,   2,   2,  "s",  3,   3,   3,   3,   3,  "s"],
              ["s",  2,   2,   2,   2,   2,  "p",  3,   3,   3,   3,   3,  "s"],
              ["s",  2,   2,   2,   2,   2,  "s",  3,   3,   3,   3,   3,  "s"],
              ["s",  2,   2,   2,   2,   2,  "p",  3,   3,   3,   3,   3,  "s"],
              ["s",  2,   2,   2,   2,   2,  "s",  3,   3,   3,   3,   3,  "s"],
              ["s", "s", "s", "p", "s", "s", "s", "s", "s", "p", "s", "s", "s"],
              ["s",  4,   4,   4,   4,   4,  "s",  5,   5,   5,   5,   5,  "s"],
              ["s",  4,   4,   4,   4,   4,  "p",  5,   5,   5,   5,   5,  "s"],
              ["s",  4,   4,   4,   4,   4,  "s",  5,   5,   5,   5,   5,  "s"],
              ["s",  4,   4,   4,   4,   4,  "p",  5,   5,   5,   5,   5,  "s"],
              ["s",  4,   4,   4,   4,   4,  "s",  5,   5,   5,   5,   5,  "s"],
              ["s", "s", "s", "s", "s", "s", "s", "s", "s", "s", "s", "s", "s"],
             ["s", "s", "s", "s", "s", "s", "s", "s", "s", "s", "s", "s", "s"],
              ["s",  0,   0,   0,   0,   0,  "s",  1,   1,   1,   1,   1,  "s"],
              ["s",  0,   0,   0,   0,   0,  "p",  1,   1,   1,   1,   1,  "s"],
              ["s",  0,   0,   0,   0,   0,  "s",  1,   1,   1,   1,   1,  "s"],
              ["s",  0,   0,   0,   0,   0,  "p",  1,   1,   1,   1,   1,  "s"],
              ["s",  0,   0,   0,   0,   0,  "s",  1,   1,   1,   1,   1,  "s"],
              ["s", "s", "s", "p", "s", "s", "s", "s", "s", "p", "s", "s", "s"],
              ["s",  2,   2,   2,   2,   2,  "s",  3,   3,   3,   3,   3,  "s"],
              ["s",  2,   2,   2,   2,   2,  "p",  3,   3,   3,   3,   3,  "s"],
              ["s",  2,   2,   2,   2,   2,  "s",  3,   3,   3,   3,   3,  "s"],
              ["s",  2,   2,   2,   2,   2,  "p",  3,   3,   3,   3,   3,  "s"],
              ["s",  2,   2,   2,   2,   2,  "s",  3,   3,   3,   3,   3,  "s"],
              ["s", "s", "s", "p", "s", "s", "s", "s", "s", "p", "s", "s", "s"],
              ["s",  4,   4,   4,   4,   4,  "s",  5,   5,   5,   5,   5,  "s"],
              ["s",  4,   4,   4,   4,   4,  "p",  5,   5,   5,   5,   5,  "s"],
              ["s",  4,   4,   4,   4,   4,  "s",  5,   5,   5,   5,   5,  "s"],
              ["s",  4,   4,   4,   4,   4,  "p",  5,   5,   5,   5,   5,  "s"],
              ["s",  4,   4,   4,   4,   4,  "s",  5,   5,   5,   5,   5,  "s"],
              ["s", "s", "s", "s", "s", "s", "s", "s", "s", "s", "s", "s", "s"],
             ["s", "s", "s", "s", "s", "s", "s", "s", "s", "s", "s", "s", "s"],
              ["s",  0,   0,   0,   0,   0,  "s",  1,   1,   1,   1,   1,  "s"],
              ["s",  0,   0,   0,   0,   0,  "p",  1,   1,   1,   1,   1,  "s"],
              ["s",  0,   0,   0,   0,   0,  "s",  1,   1,   1,   1,   1,  "s"],
              ["s",  0,   0,   0,   0,   0,  "p",  1,   1,   1,   1,   1,  "s"],
              ["s",  0,   0,   0,   0,   0,  "s",  1,   1,   1,   1,   1,  "s"],
              ["s", "s", "s", "p", "s", "s", "s", "s", "s", "p", "s", "s", "s"],
              ["s",  2,   2,   2,   2,   2,  "s",  3,   3,   3,   3,   3,  "s"],
              ["s",  2,   2,   2,   2,   2,  "p",  3,   3,   3,   3,   3,  "s"],
              ["s",  2,   2,   2,   2,   2,  "s",  3,   3,   3,   3,   3,  "s"],
              ["s",  2,   2,   2,   2,   2,  "p",  3,   3,   3,   3,   3,  "s"],
              ["s",  2,   2,   2,   2,   2,  "s",  3,   3,   3,   3,   3,  "s"],
              ["s", "s", "s", "p", "s", "s", "s", "s", "s", "p", "s", "s", "s"],
              ["s",  4,   4,   4,   4,   4,  "s",  5,   5,   5,   5,   5,  "s"],
              ["s",  4,   4,   4,   4,   4,  "p",  5,   5,   5,   5,   5,  "s"],
              ["s",  4,   4,   4,   4,   4,  "s",  5,   5,   5,   5,   5,  "s"],
              ["s",  4,   4,   4,   4,   4,  "p",  5,   5,   5,   5,   5,  "s"],
              ["s",  4,   4,   4,   4,   4,  "s",  5,   5,   5,   5,   5,  "s"],
              ["s", "s", "s", "s", "s", "s", "s", "s", "s", "s", "s", "s", "s"],
             ["s", "s", "s", "s", "s", "s", "s", "s", "s", "s", "s", "s", "s"],
              ["s",  0,   0,   0,   0,   0,  "s",  1,   1,   1,   1,   1,  "s"],
              ["s",  0,   0,   0,   0,   0,  "p",  1,   1,   1,   1,   1,  "s"],
              ["s",  0,   0,   0,   0,   0,  "s",  1,   1,   1,   1,   1,  "s"],
              ["s",  0,   0,   0,   0,   0,  "p",  1,   1,   1,   1,   1,  "s"],
              ["s",  0,   0,   0,   0,   0,  "s",  1,   1,   1,   1,   1,  "s"],
              ["s", "s", "s", "p", "s", "s", "s", "s", "s", "p", "s", "s", "s"],
              ["s",  2,   2,   2,   2,   2,  "s",  3,   3,   3,   3,   3,  "s"],
              ["s",  2,   2,   2,   2,   2,  "p",  3,   3,   3,   3,   3,  "s"],
              ["s",  2,   2,   2,   2,   2,  "s",  3,   3,   3,   3,   3,  "s"],
              ["s",  2,   2,   2,   2,   2,  "p",  3,   3,   3,   3,   3,  "s"],
              ["s",  2,   2,   2,   2,   2,  "s",  3,   3,   3,   3,   3,  "s"],
              ["s", "s", "s", "p", "s", "s", "s", "s", "s", "p", "s", "s", "s"],
              ["s",  4,   4,   4,   4,   4,  "s",  5,   5,   5,   5,   5,  "s"],
              ["s",  4,   4,   4,   4,   4,  "p",  5,   5,   5,   5,   5,  "s"],
              ["s",  4,   4,   4,   4,   4,  "s",  5,   5,   5,   5,   5,  "s"],
              ["s",  4,   4,   4,   4,   4,  "p",  5,   5,   5,   5,   5,  "s"],
              ["s",  4,   4,   4,   4,   4,  "s",  5,   5,   5,   5,   5,  "s"],
              ["s", "s", "s", "s", "s", "s", "s", "s", "s", "s", "s", "s", "s"],
             ["s", "s", "s", "s", "s", "s", "s", "s", "s", "s", "s", "s", "s"],
              ["s",  0,   0,   0,   0,   0,  "s",  1,   1,   1,   1,   1,  "s"],
              ["s",  0,   0,   0,   0,   0,  "p",  1,   1,   1,   1,   1,  "s"],
              ["s",  0,   0,   0,   0,   0,  "s",  1,   1,   1,   1,   1,  "s"],
              ["s",  0,   0,   0,   0,   0,  "p",  1,   1,   1,   1,   1,  "s"],
              ["s",  0,   0,   0,   0,   0,  "s",  1,   1,   1,   1,   1,  "s"],
              ["s", "s", "s", "p", "s", "s", "s", "s", "s", "p", "s", "s", "s"],
              ["s",  2,   2,   2,   2,   2,  "s",  3,   3,   3,   3,   3,  "s"],
              ["s",  2,   2,   2,   2,   2,  "p",  3,   3,   3,   3,   3,  "s"],
              ["s",  2,   2,   2,   2,   2,  "s",  3,   3,   3,   3,   3,  "s"],
              ["s",  2,   2,   2,   2,   2,  "p",  3,   3,   3,   3,   3,  "s"],
              ["s",  2,   2,   2,   2,   2,  "s",  3,   3,   3,   3,   3,  "s"],
              ["s", "s", "s", "p", "s", "s", "s", "s", "s", "p", "s", "s", "s"],
              ["s",  4,   4,   4,   4,   4,  "s",  5,   5,   5,   5,   5,  "s"],
              ["s",  4,   4,   4,   4,   4,  "p",  5,   5,   5,   5,   5,  "s"],
              ["s",  4,   4,   4,   4,   4,  "s",  5,   5,   5,   5,   5,  "s"],
              ["s",  4,   4,   4,   4,   4,  "p",  5,   5,   5,   5,   5,  "s"],
              ["s",  4,   4,   4,   4,   4,  "s",  5,   5,   5,   5,   5,  "s"],
              ["s", "s", "s", "s", "s", "s", "s", "s", "s", "s", "s", "s", "s"]],
    "furniture": [[0,0,0,"sphere",0],[1,4,4,"triangleset",0],[2,0,0,"sphere",0],[3,4,4,"triangleset",0],[4,0,0,"sphere",0],[5,4,4,"triangleset",0]]
}
